-------------------
----11111-11111----
---111111-111111---
--111111---111111--
-111111-----111111-
-------------------
-111111-----111111-
--111111---111111--
---111111-111111---
----11111-11111----
-------------------