11111---------11111
111111-------111111
-111111-----111111-
--11111-----11111--
-------------------
-------------------
-111-1-1-1-1-1-111-
---1-1-1-1-1-1-1---
---11-1-1-1-1-11---
----11111111111----
---------1---------