---1-----1-----1---
--111---111---111--
-11111-11111-11111-
--111---111---111--
---1-----1-----1---
-------------------
-11-11-11-11-11-11-
-1---1-1---1-1---1-
---1-----1-----1---
-1---1-1---1-1---1-
-11-11-11-11-11-11-