-1----111-111----1-
-11---111-111---11-
--11---11111---11--
---11---111---11---
1---11---1---11---1
11---11-----11---11
1---11---1---11---1
---11---111---11---
--11---11111---11--
-11---111-111---11-
-1----111-111----1-